22
18
0 0 0 0 0 0 0 0 0 0 0 0 0 0 0 0 0 0 0 0 0 0
0 3 3 3 3 3 3 3 3 3 3 3 3 3 3 3 3 3 3 3 3 0
0 3 0 0 0 0 0 0 0 0 0 0 0 0 0 0 0 0 0 0 3 0
0 3 0 0 0 0 0 0 0 0 0 0 0 0 0 0 0 0 0 0 3 0
0 3 0 0 0 0 0 0 0 0 0 0 0 0 0 0 0 0 0 0 3 0
0 3 0 0 0 0 0 0 0 0 0 0 0 0 0 0 0 0 0 0 3 0
0 3 0 0 0 0 0 0 0 0 0 0 0 0 0 0 0 0 0 0 3 0
0 3 0 0 0 0 0 0 0 0 0 0 0 0 0 0 0 0 0 0 3 0
0 3 0 0 0 0 3 3 3 3 3 3 3 3 3 3 0 0 0 0 3 0
0 3 0 0 0 0 3 3 3 3 3 3 3 3 3 3 0 0 0 0 3 0
0 3 0 0 0 0 0 0 0 0 0 0 0 0 0 0 0 0 0 0 3 0
0 3 0 0 0 0 0 0 0 0 0 0 0 0 0 0 0 0 0 0 3 0
0 3 0 0 0 0 0 0 0 0 0 0 0 0 0 0 0 0 0 0 3 0
0 3 0 0 0 0 0 0 0 0 0 0 0 0 0 0 0 0 0 0 3 0
0 3 0 0 0 0 0 0 0 0 0 0 0 0 0 0 0 0 0 0 3 0
0 3 0 0 0 0 0 0 0 0 0 0 0 0 0 0 0 0 0 0 3 0
0 3 3 3 3 3 3 3 3 3 0 0 3 3 3 3 3 3 3 3 3 0
0 0 0 0 0 0 0 0 0 0 4 4 0 0 0 0 0 0 0 0 0 0