22
18
0 0 0 0 0 0 0 0 0 0 0 0 0 0 0 0 0 0 0 0 0 0 0 0
0 22 22 22 22 22 22 22 22 22 22 22 22 22 22 22 22 22 22 22 22 22 22 22 22 0
0 22 0 0 0 0 0 0 0 0 0 0 0 0 0 0 0 0 0 0 22 0
0 22 0 0 0 0 0 0 0 0 0 0 0 0 0 0 0 0 0 0 22 0
0 22 0 0 0 0 0 0 0 0 0 0 0 0 0 0 0 0 0 0 22 0
0 22 0 0 0 0 0 0 0 0 0 0 0 0 0 0 0 0 0 0 22 0
0 22 0 0 0 0 0 0 0 0 0 0 0 0 0 0 0 0 0 0 22 0
0 22 0 0 0 0 0 0 0 0 0 0 0 0 0 0 0 0 0 0 22 0
43 0 0 0 0 0 0 0 0 0 0 0 0 0 0 0 0 0 0 0 22 0
43 0 0 0 0 0 0 0 0 0 0 0 0 0 0 0 0 0 0 0 22 0
0 22 0 0 0 0 0 0 0 0 0 0 0 0 0 0 0 0 0 0 22 0
0 22 0 0 0 0 0 0 0 0 0 0 0 0 0 0 0 0 0 0 22 0
0 22 0 0 0 0 0 0 0 0 0 0 0 0 0 0 0 0 0 0 22 0
0 22 0 0 0 0 0 0 0 0 0 0 0 0 0 0 0 0 0 0 22 0
0 22 0 0 0 0 0 0 0 0 0 0 0 0 0 0 0 0 0 0 22 0
0 22 0 0 0 0 0 0 0 0 0 0 0 0 0 0 0 0 0 0 22 0
0 22 22 22 22 22 22 22 22 22 0 0 22 22 22 22 22 22 22 22 22 22 22 22 22 0
0 0 0 0 0 0 0 0 0 0 43 32 0 0 0 0 0 0 0 0 0 0 