12
10
0 0 0 0 43 43 0 0 0 0 0 0
0 22 22 22 22 0 0 22 22 22 22 0
0 22 0 0 0 0 0 0 0 0 22 0
0 22 0 0 0 0 0 0 0 0 22 0
43 0 0 0 0 0 0 0 0 0 22 0
43 0 0 0 0 0 0 0 0 0 22 0
0 22 0 0 0 0 0 0 0 0 22 0
0 22 0 0 0 0 0 0 0 0 22 0
0 22 22 22 22 22 22 22 22 22 22 0
0 0 0 0 0 0 0 0 0 0 0 0